SSSSSSSSSD
SSSSSSSSSS
##########
#    X X #
#      # #
# E  C C #
######   #
SSSSS#####
SSSSSSSSSS
SSSSSSSSSS
