SS###SSSSD
SS#X#SSSSS
SS# ####SS
###C CX#SS
#X CE###SS
####C#SSSS
SSS#X#SSSS
SSS###SSSS
SSSSSSSSSS
SSSSSSSSSS
