SSSSSSSSSD
S#########
S#XX X   #
S# #     #
S#C  #####
S#  C    #
S# C     #
S#  E    #
S#########
SSSSSSSSSS

